INCQ_PCRfree_1-McKain_252-WiDiv_43_CCGCGGTT_Andropogon_gerardii	data/gvcf/subsample/INCQ_PCRfree_1-McKain_252-WiDiv_43_CCGCGGTT_Andropogon_gerardii.p2.subsample.g.vcf.gz
INCR_PCRfree_Loretta_12mi-3_25_TTATAACC_Andropogon_gerardii	data/gvcf/subsample/INCR_PCRfree_Loretta_12mi-3_25_TTATAACC_Andropogon_gerardii.p2.subsample.g.vcf.gz
INCS_PCRfree_Loretta_CDB-2_37_GGACTTGG_Andropogon_gerardii	data/gvcf/subsample/INCS_PCRfree_Loretta_CDB-2_37_GGACTTGG_Andropogon_gerardii.p2.subsample.g.vcf.gz
INCT_PCRfree_Loretta_SAL-3_4_AAGTCCAA_Andropogon_gerardii	data/gvcf/subsample/INCT_PCRfree_Loretta_SAL-3_4_AAGTCCAA_Andropogon_gerardii.p2.subsample.g.vcf.gz
INCU_PCRfree_Texas-1_40_ATCCACTG_Andropogon_gerardii	data/gvcf/subsample/INCU_PCRfree_Texas-1_40_ATCCACTG_Andropogon_gerardii.p2.subsample.g.vcf.gz
INCW_PCRfree_3-3-Kellogg-1271_47_AGTTCAGG_Andropogon_gerardii	data/gvcf/subsample/INCW_PCRfree_3-3-Kellogg-1271_47_AGTTCAGG_Andropogon_gerardii.p2.subsample.g.vcf.gz
INCX_PCRfree_Loretta_12mi-4_26_GACCTGAA_Andropogon_gerardii	data/gvcf/subsample/INCX_PCRfree_Loretta_12mi-4_26_GACCTGAA_Andropogon_gerardii.p2.subsample.g.vcf.gz
INCY_PCRfree_Loretta_CDB-3_38_TCTCTACT_Andropogon_gerardii	data/gvcf/subsample/INCY_PCRfree_Loretta_CDB-3_38_TCTCTACT_Andropogon_gerardii.p2.subsample.g.vcf.gz
INCZ_PCRfree_Loretta_SAL-4_5_CTCTCGTC_Andropogon_gerardii	data/gvcf/subsample/INCZ_PCRfree_Loretta_SAL-4_5_CTCTCGTC_Andropogon_gerardii.p2.subsample.g.vcf.gz
INDA_PCRfree_Texas-2_41_CCAAGTCT_Andropogon_gerardii	data/gvcf/subsample/INDA_PCRfree_Texas-2_41_CCAAGTCT_Andropogon_gerardii.p2.subsample.g.vcf.gz
INDB_PCRfree_4-1-McKain_WI-Diversity_45_TAATACAG_Andropogon_gerardii	data/gvcf/subsample/INDB_PCRfree_4-1-McKain_WI-Diversity_45_TAATACAG_Andropogon_gerardii.p2.subsample.g.vcf.gz
INDC_PCRfree_Loretta_12mi-5_27_CGGCGTGA_Andropogon_gerardii	data/gvcf/subsample/INDC_PCRfree_Loretta_12mi-5_27_CGGCGTGA_Andropogon_gerardii.p2.subsample.g.vcf.gz
INDD_PCRfree_Loretta_CDB-4_39_ATGTAAGT_Andropogon_gerardii	data/gvcf/subsample/INDD_PCRfree_Loretta_CDB-4_39_ATGTAAGT_Andropogon_gerardii.p2.subsample.g.vcf.gz
INDE_PCRfree_Loretta_SAL-5_6_GCACGGAC_Andropogon_gerardii	data/gvcf/subsample/INDE_PCRfree_Loretta_SAL-5_6_GCACGGAC_Andropogon_gerardii.p3.subsample.g.vcf.gz
INDF_PCRfree_4-2-McKain_255-IllmuisDiv_44_ACTAAGAT_Andropogon_gerardii	data/gvcf/subsample/INDF_PCRfree_4-2-McKain_255-IllmuisDiv_44_ACTAAGAT_Andropogon_gerardii.p2.subsample.g.vcf.gz
INDG_PCRfree_Loretta_12mi-6_28_GTCGGAGC_Andropogon_gerardii	data/gvcf/subsample/INDG_PCRfree_Loretta_12mi-6_28_GTCGGAGC_Andropogon_gerardii.p2.subsample.g.vcf.gz
INDH_PCRfree_Loretta_DES-1_42_CTTGGTAT_Andropogon_gerardii	data/gvcf/subsample/INDH_PCRfree_Loretta_DES-1_42_CTTGGTAT_Andropogon_gerardii.p2.subsample.g.vcf.gz
INDI_PCRfree_Loretta_SAL-6_7_TCCAACGC_Andropogon_gerardii	data/gvcf/subsample/INDI_PCRfree_Loretta_SAL-6_7_TCCAACGC_Andropogon_gerardii.p2.subsample.g.vcf.gz
INDL_PCRfree_Loretta_FUL-2_32_AGCCTCAT_Andropogon_gerardii	data/gvcf/subsample/INDL_PCRfree_Loretta_FUL-2_32_AGCCTCAT_Andropogon_gerardii.p2.subsample.g.vcf.gz
INDN_PCRfree_5-3-McKain_254-WI-Diversity_46_ATATGGAT_Andropogon_gerardii	data/gvcf/subsample/INDN_PCRfree_5-3-McKain_254-WI-Diversity_46_ATATGGAT_Andropogon_gerardii.p2.subsample.g.vcf.gz
INDP_PCRfree_Loretta_12mi-8_30_GCGCAAGC_Andropogon_gerardii	data/gvcf/subsample/INDP_PCRfree_Loretta_12mi-8_30_GCGCAAGC_Andropogon_gerardii.p2.subsample.g.vcf.gz
INDQ_PCRfree_Loretta_FUL-3_33_AAGATACT_Andropogon_gerardii	data/gvcf/subsample/INDQ_PCRfree_Loretta_FUL-3_33_AAGATACT_Andropogon_gerardii.p2.subsample.g.vcf.gz
INDR_PCRfree_Loretta_WAL-3_11_GGAGCGTC_Andropogon_gerardii	data/gvcf/subsample/INDR_PCRfree_Loretta_WAL-3_11_GGAGCGTC_Andropogon_gerardii.p2.subsample.g.vcf.gz
INDS_PCRfree_6-1-McKain-252_WI_Div_49_ATATCTCG_Andropogon_gerardii	data/gvcf/subsample/INDS_PCRfree_6-1-McKain-252_WI_Div_49_ATATCTCG_Andropogon_gerardii.p2.subsample.g.vcf.gz
INDT_PCRfree_Loretta_BB-1_18_GCGCTCTA_Andropogon_gerardii	data/gvcf/subsample/INDT_PCRfree_Loretta_BB-1_18_GCGCTCTA_Andropogon_gerardii.p2.subsample.g.vcf.gz
INDU_PCRfree_Loretta_FUL-4_34_AACAGGTT_Andropogon_gerardii	data/gvcf/subsample/INDU_PCRfree_Loretta_FUL-4_34_AACAGGTT_Andropogon_gerardii.p2.subsample.g.vcf.gz
INDW_PCRfree_Loretta_WAL-4_12_GGTGAACC_Andropogon_gerardii	data/gvcf/subsample/INDW_PCRfree_Loretta_WAL-4_12_GGTGAACC_Andropogon_gerardii.p2.subsample.g.vcf.gz
INDX_PCRfree_7-2-McKain-252_WI_Div_50_TGCGGCGT_Andropogon_gerardii	data/gvcf/subsample/INDX_PCRfree_7-2-McKain-252_WI_Div_50_TGCGGCGT_Andropogon_gerardii.p2.subsample.g.vcf.gz
INDY_PCRfree_Loretta_BB-2_19_CATAATAC_Andropogon_gerardii	data/gvcf/subsample/INDY_PCRfree_Loretta_BB-2_19_CATAATAC_Andropogon_gerardii.p2.subsample.g.vcf.gz
INDZ_PCRfree_Loretta_FUL-5_35_GATCTATC_Andropogon_gerardii	data/gvcf/subsample/INDZ_PCRfree_Loretta_FUL-5_35_GATCTATC_Andropogon_gerardii.p2.subsample.g.vcf.gz
INEA_PCRfree_Loretta_WAL-5_13_AGCTCGCT_Andropogon_gerardii	data/gvcf/subsample/INEA_PCRfree_Loretta_WAL-5_13_AGCTCGCT_Andropogon_gerardii.p2.subsample.g.vcf.gz
INEB_PCRfree_CAM807_51_ACACTAAG_Andropogon_gerardii	data/gvcf/subsample/INEB_PCRfree_CAM807_51_ACACTAAG_Andropogon_gerardii.p2.subsample.g.vcf.gz
INEC_PCRfree_Loretta_BB-3_20_GTGTCGGA_Andropogon_gerardii	data/gvcf/subsample/INEC_PCRfree_Loretta_BB-3_20_GTGTCGGA_Andropogon_gerardii.p2.subsample.g.vcf.gz
INED_PCRfree_Loretta_Ful-1_31_TTCCTGTT_Andropogon_gerardii	data/gvcf/subsample/INED_PCRfree_Loretta_Ful-1_31_TTCCTGTT_Andropogon_gerardii.p2.subsample.g.vcf.gz
INEE_PCRfree_Loretta_WAL-6_14_CCTTCACC_Andropogon_gerardii	data/gvcf/subsample/INEE_PCRfree_Loretta_WAL-6_14_CCTTCACC_Andropogon_gerardii.p2.subsample.g.vcf.gz
INEF_PCRfree_LJ-PopBB_ARA_23_CAATTAAC_Andropogon_gerardii	data/gvcf/subsample/INEF_PCRfree_LJ-PopBB_ARA_23_CAATTAAC_Andropogon_gerardii.p2.subsample.g.vcf.gz
INEG_PCRfree_Loretta_BB-4_21_TGGCCGGT_Andropogon_gerardii	data/gvcf/subsample/INEG_PCRfree_Loretta_BB-4_21_TGGCCGGT_Andropogon_gerardii.p2.subsample.g.vcf.gz
INEH_PCRfree_Loretta_SAL-1_2_AGTACTCC_Andropogon_gerardii	data/gvcf/subsample/INEH_PCRfree_Loretta_SAL-1_2_AGTACTCC_Andropogon_gerardii.p2.subsample.g.vcf.gz
INEI_PCRfree_Loretta_WEB-3_17_GACGTCTT_Andropogon_gerardii	data/gvcf/subsample/INEI_PCRfree_Loretta_WEB-3_17_GACGTCTT_Andropogon_gerardii.p2.subsample.g.vcf.gz
INEJ_PCRfree_LJ_Pop-WAL1_9_AACTGTAG_Andropogon_gerardii	data/gvcf/subsample/INEJ_PCRfree_LJ_Pop-WAL1_9_AACTGTAG_Andropogon_gerardii.p2.subsample.g.vcf.gz
INEK_PCRfree_Loretta_BB-5_22_GGTCACGA_Andropogon_gerardii	data/gvcf/subsample/INEK_PCRfree_Loretta_BB-5_22_GGTCACGA_Andropogon_gerardii.p2.subsample.g.vcf.gz
INEL_PCRfree_Loretta_SAL-13_8_CTGCTTCC_Andropogon_gerardii	data/gvcf/subsample/INEL_PCRfree_Loretta_SAL-13_8_CTGCTTCC_Andropogon_gerardii.p2.subsample.g.vcf.gz
INEM_PCRfree_Loretta_Web_15_TCATCCTT_Andropogon_gerardii	data/gvcf/subsample/INEM_PCRfree_Loretta_Web_15_TCATCCTT_Andropogon_gerardii.p2.subsample.g.vcf.gz
INEP_PCRfree_Loretta_CDB-1_36_CGCTATGT_Andropogon_gerardii	data/gvcf/subsample/INEP_PCRfree_Loretta_CDB-1_36_CGCTATGT_Andropogon_gerardii.p2.subsample.g.vcf.gz
INEQ_PCRfree_Loretta_SAL-2_3_GTATGTTC_Andropogon_gerardii	data/gvcf/subsample/INEQ_PCRfree_Loretta_SAL-2_3_GTATGTTC_Andropogon_gerardii.p2.subsample.g.vcf.gz
INER_PCRfree_Loretta_Web-2_16_ACGCACCT_Andropogon_gerardii	data/gvcf/subsample/INER_PCRfree_Loretta_Web-2_16_ACGCACCT_Andropogon_gerardii.p2.subsample.g.vcf.gz
